------------------------------------------------------------------------------------------------------------------------------------
.#..###.#.|.##...####|#......###|##.#....#.|..#.#...#.|..#..#...#|###.##...#|#....#.#.#|#....###.#|#.#.##.#..|.######.#.|...#.#..#.|
...#...#.#|#........#|#........#|#.#.##..#.|.##.#.#...|...#.#...#|##.#..#...|...#...#.#|#........#|##...#....|........##|##........|
......#.##|#....#..#.|.....#....|....##...#|##.#..#..#|###....##.|...#.#...#|##.......#|#.....#.#.|..........|.........#|#..#.....#|
...#..#...|..#.....##|##.#..#.##|#..#....##|####..#..#|#.......#.|.#.#.#..##|#..##....#|#.........|........#.|..........|...#.##..#|
###..###..|.#.###.#..|......#..#|##......##|##...#.#.#|###.#.....|.......#.#|##..#..#.#|#...#.....|...#.....#|#....###..|..#...#.##|
.#..#.#...|..#..####.|.#...#.#..|....#...#.|........#.|.###..##.#|#.....#.#.|.#......##|#.........|...#.....#|##........|..#......#|
#..#.##..#|#.....##..|.......#..|..#....#..|....#.#.##|##......#.|.....#..#.|.#.##....#|###..#....|.........#|#...#....#|#..#.....#|
#.........|.#..###...|.#.#..###.|....##....|.#...##.#.|.....##...|...#....##|#...#.#..#|#.#..#..#.|.#.#.#....|.....#...#|#...#....#|
.##....#..|..##.....#|#...#..#..|.#.#...#.#|#.#..#.#.#|##...#.#..|..#...##.#|#......#.#|#...##..#.|.......#..|.#.#..#.#.|.#..#.##..|
.#.###.#..|.##...#.##|######.###|###..#.#.#|#.##..###.|..##....#.|....#...#.|..##.###..|.#.#....##|##.#...#..|.#.....#..|...#...###|
------------------------------------------------------------------------------------------------------------------------------------
.#.###.#..|.##...#.##|######.###|###..#.#.#|#.##..###.|..##....#.|....#...#.|..##.###..|.#.#....##|##.#...#..|.#.....#..|...#...###|
..#..##.#.|..#......#|##..###..#|#....##...|...#..#...|..#....#..|.#....#..#|#.##..#..#|##...#....|...#..##.#|#....#...#|#.#......#|
#.....#...|.....##.#.|.##...##..|.#.#..#..#|#..##...##|##.#...##.|..#..#....|.#....##.#|##.##....#|###....##.|.#.###....|.#.......#|
#....##...|..#.#####.|...#......|..#..##.##|#..##.....|.###...#..|..#...##..|.###..#...|.....#.###|#.###.#..#|#..###.#..|....#.#..#|
.....#.##.|..#....#.#|##..#.#..#|##.....###|#.##.....#|##.....#.#|#.##...##.|.#.#.#...#|##.##.#.#.|..#..#...#|#....#.#.#|##..#.####|
.#.#.....#|##....#..#|##.....#..|..#.#..#.#|#...##..#.|....#....#|#.#....###|#....#....|...####..#|###......#|#...##...#|#..##.##.#|
#....#....|.#.####..#|#......###|#....##..#|###....#..|........#.|.#.#...#.#|#.#.......|..##...#..|...###..#.|....#.#.#.|.###.##...|
....##.#..|....#....#|##....##.#|#..#...#.#|#.#..#...#|#......#.#|#.#....#..|...###.#..|..#.......|.........#|#.........|.....#.##.|
......##.#|#.....#...|..#......#|#.#..#..##|#..#..#.##|#..##...##|#.....##..|......#.#.|.......#.#|##....#...|.....##..#|#...#....#|
#..##..##.|.#.##.#...|.#.##..#..|.#####....|..#..#####|####.#.#..|...##.#...|..#......#|##.##..##.|.....#..##|#..#..#.##|#...###.#.|
------------------------------------------------------------------------------------------------------------------------------------
#..##..##.|.#.##.#...|.#.##..#..|.#####....|..#..#####|####.#.#..|...##.#...|..#......#|##.##..##.|.....#..##|#..#..#.##|#...###.#.|
.....##.##|##.....#.#|##...###.#|#......#..|.#.#......|.#.####...|.#..#..#..|.....###.#|###....#.#|#.##.###..|.....##..#|####......|
...#.###.#|#...#..#..|......##.#|##..#....#|#.#.......|.#...#..##|#.##.#..#.|.#...#..#.|..#.....##|###..#...#|#...#.##.#|#....#...#|
....#.....|......##.#|#....###..|..##...#.#|#..#....#.|.....##..#|###.#...#.|...#....#.|.#.##..#..|.#....#.#.|..........|......#.##|
....##...#|##..#.##.#|#...#..##.|..........|.#....#.#.|.....#...#|##...#.###|#.#.......|.#.#...###|#..#......|.###..#...|...#..#...|
..#..#...#|##........|...#..#.#.|..##..#...|..#.##...#|###.#...#.|..#...#.##|#..#.##..#|#.#.....#.|...#.....#|#.......##|#....#....|
#.#...#..#|#.....#...|...#......|.#.......#|#..#....#.|..........|...##....#|#.....#...|..##.....#|##.....#..|.#........|.......#.#|
##....#.#.|...#...#..|..#......#|#..#.#..##|#..#...#..|.#..##.#.#|##.....#..|.....###.#|#....#....|..##.....#|#...#....#|#.....#..#|
..........|...##.#...|.##...#...|.........#|#.#..##...|.#..#..#.#|#.#.....#.|.....#....|..#.#...#.|.##.#....#|###.#....#|#....##...|
.#..#...#.|..###.....|..#.#.#.##|######.#..|.####..###|#.#.##..#.|......#.##|#...#.###.|.#...#####|#####.####|#.##.###..|.##.##.###|
------------------------------------------------------------------------------------------------------------------------------------
.#..#...#.|..###.....|..#.#.#.##|######.#..|.####..###|#.#.##..#.|......#.##|#...#.###.|.#...#####|#####.####|#.##.###..|.##.##.###|
...##..##.|......#.#.|..##...#..|......#.#.|...#......|..#..##...|..##....##|#.#...##.#|#..#.#..#.|.##..#....|.#..##...#|###..####.|
..#...#...|...###..##|#..#...#..|........##|#...##....|...###.#.#|##..##...#|#....#...#|#.##....##|##........|...##.....|.##..###.#|
..#......#|##..##..##|#.......#.|....#.#.##|#.#...#..#|#...#....#|###.#..#.#|#.#..#...#|#.#...##..|.##..#....|.#.#.#.#..|.#...#....|
##..#.#...|...##..#.#|#.......#.|........##|##.##.####|##.....#..|..........|..##.##...|.#.....#..|.#....#..#|#.......#.|.#..#...##|
#.##......|.#.#.....#|#...#.##..|.#.##.#...|.....###.#|#...#....#|##.##..#..|..........|...#.#.#..|..##...##.|.##.#.#..#|#........#|
#...#....#|##........|.#.......#|#......#.#|##.#.#....|..#.#.#..#|#.#.......|..#.#.#...|.##.......|...#......|.#.###.#..|.#...#....|
.##.......|...#...#..|....#..###|#.......#.|..#.###..#|#.#..#....|...#.#..#.|.....#....|...#..#.##|#..#....#.|.#..#...##|#.....#...|
#.......##|###....#.#|##.......#|#...#.#.#.|.#.###.#.#|#..#.#....|.....#....|.....#....|........##|##...#.#.#|#...###...|.##.....#.|
#...#.####|#..######.|.#.##.#.#.|.....#...#|##.#..##..|.##.###.#.|.####.#.##|#..#....#.|..##...###|#.##...##.|.###..#.##|#.#..####.|
------------------------------------------------------------------------------------------------------------------------------------
#...#.####|#..######.|.#.##.#.#.|.....#...#|##.#..##..|.##.###.#.|.####.#.##|#..#....#.|..##...###|#.##...##.|.###..#.##|#.#..####.|
....#.##..|..#.##...#|#..#.##..#|#.........|....#..#..|....#.##..|.#..#.....|..#.##.#.#|#....#....|...#..###.|..##.#.#..|.#...#....|
...#....#.|....#...#.|....#.....|......###.|..#.#.....|.........#|#.#.....##|#.....#.##|#.......##|##.....#..|......####|#........#|
.....#....|.........#|#.......#.|.##......#|#..#...##.|...##.....|...#..#...|.###.#...#|#.....#...|......#...|..##.#.#..|..#....#..|
#..##.....|..##...#..|..#......#|#.........|..#....###|##..#..#..|...#......|..####..##|##....#...|...#.....#|##.#..##..|.......##.|
.....#....|.#...#...#|##.##...##|#.........|.##.....#.|..#..##.#.|.........#|#..#.#..#.|..#.#...##|#.....###.|....#...##|#.#....##.|
###.#.....|.##......#|#.........|...#.....#|##.#...#..|.......#.#|##.......#|#.#...###.|.#.....#.#|#.....#...|..###.###.|.#...###..|
......#..#|##........|..###.#.##|#.#....#..|.#.###...#|#.......##|###......#|#.....#.#.|.....#....|...##..#.#|#..#.#...#|##.......#|
#.#.#...##|#...#.##..|..#.......|.#.#...#.#|#####.#..#|#.....##.#|#......#..|.#.....#..|.##....#.#|#.#..#.##.|.......##.|...#...#.#|
#...##.##.|.##...#..#|####.#..#.|.##..#.#..|....#.#.##|####..##.#|#.#.####.#|#..####.#.|.###.##...|..#...###.|.#.#......|..#.#.#...|
------------------------------------------------------------------------------------------------------------------------------------
#...##.##.|.##...#..#|####.#..#.|.##..#.#..|....#.#.##|####..##.#|#.#.####.#|#..####.#.|.###.##...|..#...###.|.#.#......|..#.#.#...|
#....#..##|#......#.#|#........#|#..##.#...|..##...##.|...#.#.#.#|##.#....#.|.##..#....|.#...#...#|#...####..|....##....|..........|
......#...|..#....##.|...#.#....|.#.....#..|.##.....##|#...###..#|#.#.......|...#......|....#.##..|.#.......#|#.###.....|...#..#..#|
#..#...###|#......#.#|#..#.#.##.|...####.##|##...#.###|###.##.#..|.......#.#|#..#...#.#|#.....####|#.......#.|....#...#.|......#..#|
#..#..#.##|###.#.#.##|#.......##|#.#..###..|.#....##..|....#..#..|.......###|#.#..#.##.|...##.....|......##.#|##.##....#|##......##|
.....#####|##..#.....|.......###|####.#....|...#....#.|...#......|.##......#|#...#...##|#.#....###|#.#..#.###|#..#.#....|.....#....|
...#....##|##....#...|.#......#.|..#.##.#..|.##...#..#|##.#....#.|.....#.#..|.......##.|...##.#...|..#.#..#..|..#.....#.|.......#.#|
##.##....#|#.##.###.#|#....#####|#.....#.#.|.##....#..|.#..#.##..|......#.#.|..#.#....#|#....###..|...##.#...|.........#|#..##...##|
.........#|#.#....###|#...###..#|#.###.....|..#.....#.|.#...#....|.........#|#..#.....#|#..#.#####|#.##.#...#|#.........|.....#...#|
.#.#.#...#|#.#..##.##|##....####|####...###|#.####.#..|.#.###....|..##.####.|.#.##.####|#.###.....|...##.##.#|##.###.#.#|#.#....#..|
------------------------------------------------------------------------------------------------------------------------------------
.#.#.#...#|#.#..##.##|##....####|####...###|#.####.#..|.#.###....|..##.####.|.#.##.####|#.###.....|...##.##.#|##.###.#.#|#.#....#..|
....#####.|..#....###|##.#...#.#|#..##....#|##..#.#.#.|.....#....|..#.###..#|#..#...#.#|#..#.#...#|#...###..#|#.#......#|#.#.#....#|
#..#...#..|.##..##..#|#.#.##.###|#...###.#.|..#....#..|..###.#..#|#.##......|..#.....##|#..#....#.|..#.#.#...|....#.....|.#...#....|
###......#|###...#..#|##.#....#.|.....#..##|#.##.##.##|#.#.#...#.|..#......#|#.......#.|........#.|....##.#.#|#.....#..#|##.......#|
#...#...##|#.##.....#|#...#...#.|....#.....|.##..#....|.#....#..#|##.......#|#....###..|..##.#####|##.#...#.#|#........#|##...#.#.#|
#.##....##|#....##..#|#....#.##.|.#.#.#....|..##...#..|..#.#.##..|...#....##|###..###.#|#...#.#..#|#...#..#..|.#..##....|.##.....#.|
#.#...#.#.|......##..|.##.....##|#.........|..#.....#.|...#.##...|........#.|...#..#..#|#...#.#..#|###.......|..#......#|##........|
#....##.#.|...#...#..|..#......#|#..##....#|##..##....|..#..#....|.#........|..#.#..#..|....##....|.....##...|...#.##.##|#..#..###.|
#...#.....|.#....##..|....#..##.|.##..##.##|#....#.##.|..#.#.....|..#......#|#.......#.|.#..#....#|##...#...#|###.......|..##...#..|
#.####...#|##.##...#.|.#####.#.#|####.###.#|#....####.|....#.###.|...###...#|#####.#.#.|.##..#..##|###..#...#|#.##.#.##.|.#.##.##.#|
------------------------------------------------------------------------------------------------------------------------------------
#.####...#|##.##...#.|.#####.#.#|####.###.#|#....####.|....#.###.|...###...#|#####.#.#.|.##..#..##|###..#...#|#.##.#.##.|.#.##.##.#|
#.#.#....#|#.......##|#..#..#.##|##...#..#.|.#......#.|..........|.##..#.#.#|#.#.......|...#......|.......#.#|#.#..##.##|#.......##|
#.#...#..#|#.#.#.####|#.#.#.###.|.#.##..#..|.##.....#.|.........#|##...#.##.|.........#|#...##.#..|..#...#.##|#.#.....##|#..#......|
#.#.#.#.#.|.###..#.#.|.......#..|.........#|#.#.......|...##..#.#|#...#....#|#..#.....#|#..#..#...|...#..#..#|#...#...##|###..#...#|
#..##....#|##..#..#..|..#.###.##|#.##....#.|.#......#.|.##..#....|.......#.#|#...###..#|#.....#.##|#.....#...|..#..##.##|###.#.....|
.##...#..#|#..#.....#|###.#.....|.#..#.#...|.....#..##|#..#..#...|.#.###...#|##........|....##...#|#..###...#|#.#.....#.|..#..#..##|
.##......#|#....#....|.......#.#|#..#.##...|.....#.#..|......#.#.|..####....|..#.......|..#.....#.|........#.|..##..#..#|#...#.#...|
#.#.....##|#.#......#|#..#.#..##|##.....#..|...#..#..#|#........#|#.#......#|#.##.....#|##.#.#.##.|....#...##|#.##.....#|#....#...#|
##.#..#...|.#...#...#|#.#.##.#.#|##........|......##.#|#.##......|.#........|..........|..#..#...#|#.......#.|..#.#...##|#.#.......|
#..####.##|#.###.###.|.###..#..#|#.#..##..#|#....#####|###..#.###|#.#.###...|...#####..|.###...#.#|##..#....#|##...###.#|#.#..#...#|
------------------------------------------------------------------------------------------------------------------------------------
#..####.##|#.###.###.|.###..#..#|#.#..##..#|#....#####|###..#.###|#.#.###...|...#####..|.###...#.#|##..#....#|##...###.#|#.#..#...#|
..#.#..#..|.#...#...#|##......#.|.........#|#........#|##...#.#..|....##....|..........|.....##.##|#......##.|.#...###.#|##..##...#|
#......#.#|#........#|#......#..|.#.......#|#...#.#..#|#.........|......#...|.#........|....#...#.|.....##..#|#....#...#|##........|
...##..#.#|#......#.#|#...#....#|#..##..###|#..#..##.#|#.....#.##|##.#.....#|#.....##..|..........|.##.##...#|#...#...#.|.....#....|
.....#....|..#......#|#......#..|........##|#....##.##|###.##.#..|..#.......|.#.#...###|##..#.....|..##.#...#|##.......#|#.....#...|
......##.#|#......###|##.......#|#........#|#..#.#.#..|...#.##.#.|.#.#..#...|.#.....#.#|####....##|#...##....|..#.#....#|#.#.##....|
##........|.....#.##.|..#.......|.....#...#|#..#.#.#.#|#....##...|.........#|##..#.....|.##..##.#.|...###.#..|..##....##|#.#......#|
.#..#....#|#.....#..#|#.##..#...|...####.#.|..........|....#.#...|.#........|.#.......#|####....##|##..#.#.##|##...##...|.#.#.....#|
...#.#.#..|........##|#..#..###.|.#...##...|..#.##...#|##........|..#..#....|..##....##|#.#....##.|.###..#..#|###.#.....|.#.....#..|
#######.##|####...#.#|#....##..#|###.#.#..#|#..###..##|#.##.#.#..|..##.#####|#.###.##.#|#.#.##.###|##.###...#|#.##....##|#....#....|
------------------------------------------------------------------------------------------------------------------------------------
#######.##|####...#.#|#....##..#|###.#.#..#|#..###..##|#.##.#.#..|..##.#####|#.###.##.#|#.#.##.###|##.###...#|#.##....##|#....#....|
##....#...|...##....#|#.....#..#|##..#....#|#.#...###.|.##.......|....#.#.##|#...#.....|..#.#....#|##...#....|.#....#.##|##..#.....|
..#...##..|.##...#.#.|.#..##..##|##.#.....#|####..#...|.#..#..#..|..#.....#.|.....#.#..|.....#.###|#.....#..#|##.....###|#.....#..#|
#.###.#...|.#.#.#####|##.#....##|#.#.#....#|#.#..###.#|#..#.#....|....#....#|#...##..#.|........#.|.##....#..|.##...###.|..........|
######.##.|......#..#|##........|....#...##|#.#.#...##|#.##.#...#|#.#......#|#..#.#.#..|.#.#.....#|#.#....#..|..#....##.|...###...#|
..#.....#.|..#..#...#|#....#...#|#....#..##|#..#.##...|.#.##.#..#|#.....#..#|#.#.##.#.#|###...#.#.|......##..|.#....#...|...###.###|
#...###.##|#.#..#.#.#|#.....#...|.##..#..#.|..#.###..#|#.#....#.#|#.#.##.#.#|#...#...#.|.........#|##....#...|.#........|....#.#...|
.....#.#.#|#.#......#|#.....#..#|#...###.#.|.....##...|...##....#|#..#...###|##..#.##..|...##..###|##.#......|....#.....|......#...|
##.#..#...|.#.####...|..##.#...#|#.#...##.#|#....##..#|##..#.....|..##..#..#|#........#|#......###|#..##.#...|.#....#..#|#....#..#.|
#..#.##.##|###.#.##..|.......#.#|##..#.#.##|#..#..##.#|#...#.#...|.#...###..|.#..#####.|...##.#.#.|.#.##.#..#|##.#.#..#.|........##|
------------------------------------------------------------------------------------------------------------------------------------
#..#.##.##|###.#.##..|.......#.#|##..#.#.##|#..#..##.#|#...#.#...|.#...###..|.#..#####.|...##.#.#.|.#.##.#..#|##.#.#..#.|........##|
#.....#..#|#.#..##...|........#.|.##.....#.|..####...#|#..#.###.#|#..#..#..#|#....#.##.|..#..#...#|##.##.#.#.|..#....#..|.#...#...#|
.....#.#.#|#.###.#..#|##..#.....|.#..#..#..|...#.#...#|#.####.#..|.......##.|...#...##.|.#.##....#|##..#....#|####.#.#.#|###.....#.|
###.......|.#..##.#..|...#.#...#|#..#.#...#|#.#......#|##..#.....|....###..#|##........|.#.#...##.|.#....#.#.|......#...|..........|
...##....#|##.....#.#|#.#...##..|..#####.#.|.....#.#.#|#....#...#|##.##...##|#.......#.|.........#|##.#.....#|#.##.....#|#.#......#|
..#..#...#|#.#...#...|.#....##.#|##.###...#|#.#...#...|.#.....#..|.#...#...#|#.#..##.##|#...#.....|.#........|...#......|......#..#|
#.....##.#|#.#..##..#|#.#..##.#.|...#...###|#........#|#.#.#....#|#......###|#......#.#|#..#....##|#.#......#|#.....#..#|##........|
#.#..##.##|#..##.#.##|#..#......|.......#.#|#.#.......|...#.#..##|#.#..#....|.####...#.|..#...#.##|#.......##|#..#...#..|..#...####|
...###....|...#..#...|........##|#..##.....|.#......#.|.........#|#.....#.#.|..####..#.|.#.......#|#........#|#.....##.#|#..#......|
###.#...#.|...##..#..|.#.......#|##...#..##|#..##..###|#.#..##...|..#.#..#..|.....#.##.|.#.#.#.###|###...###.|.#..###...|.##.###.##|
------------------------------------------------------------------------------------------------------------------------------------
###.#...#.|...##..#..|.#.......#|##...#..##|#..##..###|#.#..##...|..#.#..#..|.....#.##.|.#.#.#.###|###...###.|.#..###...|.##.###.##|
.#....#.##|#....#.#.#|#.#.##...#|#.#..##..#|#...#...##|#...#..#..|.......#.#|#.##.#..##|#..#....#.|........##|####..#..#|##.#.#.##.|
##..#..#..|....#....#|#...#.#..#|#....#..#.|..........|.#.....##.|..........|......##.#|##...#.#.#|###.......|.#.####..#|#.#.##...#|
#....#....|.#........|....#....#|#..#....#.|...##.....|......#..#|#.#.###..#|#....#.#.#|#.....#...|.........#|#.###....#|##...#...#|
#.#...#...|..#..#.##.|.#.#....#.|..........|.#..#.#..#|#..#.#..#.|......#...|.#...####.|..........|..........|.#....#.#.|...#.....#|
###.##.#..|.#....#.##|#...##.#..|.#.....###|#.#..#....|........#.|.....#....|..#.....#.|.#........|...##....#|#......#.#|#.##.#.#.#|
##.#...#.#|##.#......|.#....#.##|#...##...#|#..###.###|##..#.#...|...#..#.##|##.....##.|..........|..##..##..|...#.#...#|#...#.##.#|
....#....#|#......#..|.#........|..#...#.#.|..##..####|#.......##|#.....#...|.........#|#..##.#...|....#....#|#.........|.#........|
#..#....#.|.#.......#|#....#....|....#..#.#|#.........|..###..#..|..###.....|......#..#|#....#.#.#|#.....#..#|##........|.......#.#|
###..#..##|#.##......|.#...##..#|#..###.#..|.#..#.#..#|##...#####|#..##.....|.#.#...#..|.#......##|#.#.####..|...####..#|####....#.|

