------------------------------------------------------------------------------------------------------------------------------------
.#....####|#..####...|..####.#.#|##......#.|..#...#.#.|.....##..#|#####...##|#..#.#..#.|..#.###..#|#..##...#.|......##.#|##..#..###|
#.#.......|........##|#..#.....#|#.#.#....#|#..#......|.....###..|..#..###..|.........#|#.#..#....|....#....#|#.......#.|.#....#..#|
........#.|.........#|#....#....|...#.##..#|#.........|...#.....#|##.......#|####..##..|.#.#...#..|........#.|..#......#|#....#....|
#.##.#...#|#...#.#...|..##..##..|..........|.##.....##|##.#..#...|...#.#..##|###.###..#|#...##...#|##.#....#.|......#.##|#.#...#.##|
#.#.#.##.#|#.#......#|#....##...|........#.|.#.....#..|....#.....|.#........|....#..#.#|###.....#.|..#.##...#|##.#....#.|..#.##.###|
#.....#...|.#.#....#.|..........|..........|.####...#.|...#......|.#..#.#..#|#..#.#..#.|..........|.#....#.#.|.##.#..#..|...#...#.#|
#...#...##|#....###.#|#.........|...#.....#|#.#.#....#|#..###.#.#|#..#......|.....##...|.#....#..#|#....#....|........#.|....#....#|
#...##.#.#|#..####.#.|.......###|#.#.#...##|#.##......|..........|.##.....#.|..........|.#..#....#|#..#.#...#|#....#....|..#..#..##|
.##.#.#.##|#..#..####|##........|.#....#..#|##..#.##.#|#.#.......|..#..#...#|##...#...#|#..##..#.#|#...##.#.#|#.#.#....#|##.#....#.|
##.###.##.|...###..#.|.###...###|###.#.#.#.|.##.#.....|..#..#.#..|...##..#.#|###..##..#|##..#...##|#.......#.|..#..##...|.#...#.###|
------------------------------------------------------------------------------------------------------------------------------------
##.###.##.|...###..#.|.###...###|###.#.#.#.|.##.#.....|..#..#.#..|...##..#.#|###..##..#|##..#...##|#.......#.|..#..##...|.#...#.###|
......#..#|#.##.....#|#........#|#.......#.|.#..####..|.#.#.....#|#.........|.#......#.|.....##..#|##........|...#..#...|....###...|
####...#..|..#...#..#|##.......#|##.#...#..|.#...####.|....#..#.#|##..#.#...|.......#.#|#.#.......|......#..#|##.#.##..#|##.##..#.#|
........##|#..#.....#|#......#.#|##....#..#|#.#......#|###......#|#....#.#.#|#........#|###...#...|.#.##..#.#|#..##..#.#|#.##.....#|
#..#......|......#...|........#.|.....#...#|##.##..#.#|#...#...#.|..#.....#.|...#...#.#|#...###.##|#.##....#.|...#...#.#|#...#..#..|
#......#.#|#.....##.#|#.....#.##|#.........|.#.......#|##...##.##|#...#....#|#.#.#.....|.#.#####..|..##...#.#|#.#.....##|#....##...|
..........|...#......|.#.#....#.|.##...#.#.|........##|#..###....|.....#..##|#......#.#|#...#.#..#|#...#.#...|..#.##..#.|.......###|
.#.....###|#.#.#.####|#....#..##|#....##.#.|.##...#...|.##.......|..#.####.#|#...#.#...|..#..#..#.|.....#..##|#..#.###.#|#.#.#.....|
#...#...#.|..#....#..|.#.#.##.##|#...#..#..|.##.#....#|#..#..#..#|#.###.#..#|#...####..|.#.....##.|.#........|...##..#.#|#..#.....#|
##........|.#..#.#.##|#..#.##.#.|.#.#.##...|.#####..#.|..###...#.|...#.#...#|#.##..#..#|##.#.#..##|#.#.......|..##.#.###|##.##.#..#|
------------------------------------------------------------------------------------------------------------------------------------
##........|.#..#.#.##|#..#.##.#.|.#.#.##...|.#####..#.|..###...#.|...#.#...#|#.##..#..#|##.#.#..##|#.#.......|..##.#.###|##.##.#..#|
.#..#....#|#..#....#.|...#.##..#|###......#|#........#|#..#..##..|.....#..##|#..##....#|#.##...#.#|#...#.##..|...####.#.|...#..#.##|
...#......|.....#....|......#.##|###..##...|..##.#..##|###...#..#|#....##...|...##.....|.#.###...#|#..#.....#|#......#.#|#.#.#.....|
...#.#....|........#.|...#....##|#.........|.#...#...#|#.#.##.#.#|#.#....#.#|#..###.#..|.#..#..##.|...#.....#|#.#.#..#.#|##.###...#|
###.###...|...#....#.|..##......|.#.#...###|#.#.##.#.#|#..#.....#|#..#.##.#.|...##.#..#|##..#....#|#...#....#|#...#..#..|.#.....#..|
#...###...|.##....#..|..#....#.#|#.....#.#.|..#.#.#..#|#......#.#|#...#.##.#|##...#.#.#|##...#....|........##|#..#......|.##.######|
..........|.###...##.|..#....##.|.#........|.#..##...#|#....#....|....#.#..#|#.###..#.#|#....#.#.#|##....#.##|#####.#.#.|...#.###.#|
#..#.....#|###.....##|#..#.....#|###.#.....|..#.#.....|.#.....#..|..#..#..#.|...#..####|#.....#.##|##..##..#.|.#.#...##.|..##...#..|
.....#..##|##.#....#.|....#...##|#....#.#..|.....#...#|##.#.#....|.......##.|.###...#.#|#....#..##|#..#.....#|#....##...|...#....##|
....#....#|##....##.#|#...###.##|###.##.#.#|#.##.###.#|#####.##..|..#.#.##.#|##..###..#|#..#.#.###|#..##....#|#.#...####|##.#######|
------------------------------------------------------------------------------------------------------------------------------------
....#....#|##....##.#|#...###.##|###.##.#.#|#.##.###.#|#####.##..|..#.#.##.#|##..###..#|#..#.#.###|#..##....#|#.#...####|##.#######|
..#.....#.|.....#.###|#..#..###.|.##....#.#|##....##..|....#..#..|........##|#...##.#..|...##...#.|.###..#..#|##........|..#.#.#...|
#.....#.#.|...##...##|##.#.#..##|##....####|#.......#.|........#.|...#.#....|..........|.#.####...|...#..##.#|#..#.....#|#....#..#.|
#......#.#|##....##..|..#.###...|.#.##..##.|.....#..##|#.........|...##....#|#.#.#.#..#|#...#.....|.......#..|.##.#.....|........##|
....##.#.#|#....#.#..|....##...#|##....####|#.#.....#.|...#..#.#.|.#.##.#...|..#.#.#..#|#........#|#.......##|###......#|#.##......|
...#.....#|#.......##|#...#.##..|.....#..##|###...#.#.|.......#..|..#.##.###|##.##....#|##........|..#......#|#......#..|....#.....|
....#.....|.#...#...#|#...##.##.|..........|..##.....#|#.....#.##|##.#.....#|#.##..#..#|###..##..#|#....#...#|#.#......#|#.#..##...|
........##|#...#....#|#..##.....|.#...#....|........#.|...#......|.........#|#..#.#...#|#.......#.|..#......#|#........#|#.#......#|
#...##..##|#.###...#.|.##......#|##.##.....|..........|....##....|..#.#...##|#........#|#.........|.#......##|#...#...#.|..#..#.#..|
#...#..#.#|#.###...##|#....#..##|#.#...###.|..#####...|...###.#.#|###.#..###|#####....#|#..##..#.#|#..#..###.|.###.###.#|##.####..#|
------------------------------------------------------------------------------------------------------------------------------------
#...#..#.#|#.###...##|#....#..##|#.#...###.|..#####...|...###.#.#|###.#..###|#####....#|#..##..#.#|#..#..###.|.###.###.#|##.####..#|
.......#.#|##...#.#..|.#.......#|#...#..#..|..........|........#.|......##.#|#.##......|........##|#.#.##.#.#|#...#...#.|...#..#.##|
#...#....#|#.....##.#|##...#....|.##.#.#.##|#.....##.#|#......#.#|#........#|#..#..#...|..#.....##|##..#.#..#|#......#.#|##.....#.#|
...#.#...#|#..#..##..|.#........|.#.....#..|.......#..|....####..|.#.#......|..#.#.....|...##.#..#|#.#.......|....#....#|#......##.|
##..#..#..|.#.....#.#|#...###..#|#...##....|........##|#...###.#.|...#..#..#|##..#.....|...#.#..#.|.....#.###|#.....#..#|#..#...##.|
.....#.###|##.##..#..|...#.....#|##.#.....#|#..###...#|#.#.......|....#..##.|.#......#.|.#....##.#|##.###.#..|..#..#..##|#....##..#|
#...#..###|##...#...#|#..#..#...|...#..#..#|#.....#..#|#....#...#|#.#..##...|.......#.#|#.........|..#.......|.#.#..###.|.#.#.#.#.#|
......#..#|##.....#.#|##.#...#..|..#.##...#|#.........|.##.#...##|#.........|.#.....##.|..#..##.#.|.###.#.#.#|####.#.#.#|#..#...#.#|
##.......#|##.##..#.#|#.#.......|......#...|.......#.#|#.#.#..##.|..........|.#......#.|.#..#...##|##.#..#..#|##.......#|#....#.#.#|
#.##.##.#.|.##.#.##.#|#...#..###|##..#..##.|.#.#.#####|#...###...|.###.#....|.####....#|#.###.####|#.#.#####.|.#...##.##|#...####.#|
------------------------------------------------------------------------------------------------------------------------------------
#.##.##.#.|.##.#.##.#|#...#..###|##..#..##.|.#.#.#####|#...###...|.###.#....|.####....#|#.###.####|#.#.#####.|.#...##.##|#...####.#|
..#...##..|.......###|#...#...##|#....#..#.|.#.......#|#......#..|.....#.#..|.##.#....#|##.##..##.|.##..#....|..##....#.|.....#...#|
.###..#..#|##.##.#...|...##.....|....##....|..#..#.#..|........#.|....#..#..|....##..##|#....##..#|#......#..|..#...#...|.#.##....#|
........##|#......#..|.......###|#..#.#...#|#..#..#...|.#........|...##.#...|.#.....#..|.........#|##.....##.|..##......|.#.#...#.#|
.#.....##.|....##..#.|..#..#...#|#..#.#...#|#.###..###|##....#...|..##.#.#..|..#...##..|....#.#.#.|.##.#....#|#..##....#|##....##.#|
#.#.#...##|#........#|#.#...#.##|#####.##..|..###....#|#.......##|#..#....#.|....#..##.|.....#....|.#...#...#|#.....##.#|##...#...#|
#.......##|#..#.....#|#.#.##....|.#........|.#.......#|#......#..|.#...#.#.#|##.##.##.#|##..#.....|.#....#.##|#..#...###|#......###|
....#...#.|.....#....|...#.#.#..|.#....#..#|##.....#..|......##.#|#..#.###..|..#....#..|.#.###...#|###.##.#.#|#..##..##.|..#...#..#|
#....#.#.#|#......#.#|#..###...#|#...#.#..#|#.#...#..#|#..###.#..|....#.....|.#.#.#..##|#....##..#|#.#...#.##|###....#..|.#####....|
..#....#.#|#.#.###.##|#.##.##...|.....###.#|####.##.#.|.####.##..|....###.#.|..#.####.#|###...####|####....##|##.##..#.#|#...#.#.#.|
------------------------------------------------------------------------------------------------------------------------------------
..#....#.#|#.#.###.##|#.##.##...|.....###.#|####.##.#.|.####.##..|....###.#.|..#.####.#|###...####|####....##|##.##..#.#|#...#.#.#.|
#...#.....|.........#|#...#.##.#|#####.#..#|#.....#..#|#.........|....#...#.|.#.....#..|.....###.#|#..###...#|###....#.#|#.........|
##...##..#|#.........|...#.##...|..###....#|#....#.#..|.#.#......|..##.#..#.|..#....##.|.#.#.....#|#####....#|#.###.##.#|#....##.##|
#.#.......|.#.....#..|..#..#.#..|...#.##...|.##.......|..#.#.....|.#....#.##|#..#...##.|..#.##.#..|.#......#.|...#....##|##....#...|
....#.....|....#.#..#|###.#..#.#|###....#.#|##...#...#|#......##.|......#...|.#....#...|....#.####|###.......|.....#..##|#####.....|
##......##|#....##.##|#.##......|.....##...|.##.#..#.#|###.......|..#..#....|..##....#.|..###..#.#|##.......#|##.#.#.###|##.#..#..#|
#..#......|.#...#....|.#.......#|####.....#|#.#...#..#|#.#.......|..#.##.###|###.#...##|##.####...|.##.#.#..#|#.#......#|###...#..#|
#..#..#...|.....###.#|#.......#.|..##.#....|......#...|.......#.#|#..###...#|##.....##.|..#.....#.|....#.#...|.##....#..|...#......|
..........|....##....|..####...#|#...#...#.|....#..##.|.#....#.##|#.#.#.#...|.##...##..|...#.##..#|#........#|#.#......#|##..#....#|
...#.#.#..|......#.#.|.###...#..|...##.###.|.#.####..#|#.####.#.#|#.##..####|##.#.#....|..#.#..##.|.#..#.####|#..#...##.|.##.##...#|
------------------------------------------------------------------------------------------------------------------------------------
...#.#.#..|......#.#.|.###...#..|...##.###.|.#.####..#|#.####.#.#|#.##..####|##.#.#....|..#.#..##.|.#..#.####|#..#...##.|.##.##...#|
#.#...#...|.##.......|.##.#..#.#|#.#....##.|..#.....#.|..#......#|#.##.....#|#..#.#####|#.#...#.#.|.......#..|..##.#...#|##...#.#.#|
#.......##|#...#.#..#|#.#..##...|....#.....|.#.#.....#|#......###|##.......#|#...###.#.|..#....#.#|##.#.###..|........##|#..#......|
..###...#.|.###.###..|...#.....#|#.#.....#.|.###...#.#|#.......##|#.#.......|..#...#.##|#.....#...|.........#|#......##.|.....#.###|
.##....#.#|##...#....|.###.....#|##...#.#..|.#..#.#..#|#.........|.#.##..#..|.#.....##.|.........#|##...##.##|#...#...#.|....#.....|
.##.......|..##..#.##|#.....#...|...#....##|##..####..|......#...|..#..#..##|###....#..|.........#|#......#..|..#...##..|.....##..#|
..#....#..|..#.#.##..|...#......|...#.....#|#...#.###.|...#..#...|.....##...|.##...#..#|#......##.|.#.......#|#.........|....#.....|
#........#|####......|..#.....##|##.......#|##.#.....#|##.....#.#|#.........|.....#.#..|.###......|.....#....|.#...#....|.#....#...|
....#...#.|..#.#.##..|.###..#...|....#....#|#.#.##.#..|.....#..#.|..##.#....|..#..#....|.........#|#..##.#..#|#...##.#..|..##.#....|
.####..#.#|##.#..###.|.##...##.#|###...##..|.#....#..#|##.#.####.|.#.###.##.|..##..#.##|#...#.....|.#.#.##.#.|.######..#|####.#...#|
------------------------------------------------------------------------------------------------------------------------------------
.####..#.#|##.#..###.|.##...##.#|###...##..|.#....#..#|##.#.####.|.#.###.##.|..##..#.##|#...#.....|.#.#.##.#.|.######..#|####.#...#|
.#.....##.|...###...#|#.#.#...##|##........|....#.....|....#.....|....#.#..#|#.#.###.#.|.#.#.#...#|#.......##|#.#....###|##.......#|
...#.....#|##...#..#.|.#....#..#|##.#..#...|....#.....|.#..#.#...|....#..#.#|#..###.#..|.#.......#|###..#....|..#...#...|.......##.|
....#...#.|..#.###.#.|......#...|.......##.|...#.#.#..|.......#.#|#..#.#.#..|....#.#.##|#.#......#|#.......#.|........##|#....#...#|
#........#|#..#.#.##.|.##...##..|..#.#.#...|..........|..#..##.##|#....#...#|#.###.....|...#.##.#.|..##.#...#|#.....#.#.|......##.#|
##...#..#.|.#.......#|#..#....#.|..#.....#.|...##.##..|..........|..#.....##|####.##.##|##........|.#.......#|#.#..##...|...#.#..##|
....#...#.|..#.#.#.#.|....#..##.|..##...#.#|#...#..#.#|#.#..#.###|#....#...#|#..#...#.#|##.#.#....|.#.......#|##..##..##|#......#..|
#.###..##.|.....##...|........##|##....##.#|#...#....#|#...##..##|#.#.###...|....##...#|##........|..#...#..#|##..###...|...#...#..|
.####..###|#...##..#.|....#..##.|.#..#.#..#|#.##...#.#|##....##..|...##..#..|......#...|.#.#......|..#...##..|.#.#......|.##..##...|
###.##.##.|..###.##.#|####.#####|#####...#.|.###.#...#|##.#......|.#..##.#.#|###..####.|..#.######|##.#.#.#..|.....###..|.#...#..#.|
------------------------------------------------------------------------------------------------------------------------------------
###.##.##.|..###.##.#|####.#####|#####...#.|.###.#...#|##.#......|.#..##.#.#|###..####.|..#.######|##.#.#.#..|.....###..|.#...#..#.|
...##....#|#....#.###|#....#.##.|.#...#.#..|....#.....|.#.....#.#|#.#..#..#.|...##..#.#|#.........|...#...##.|...#.##...|..........|
#..#.....#|#....#...#|#.....##..|....#....#|#.###.....|..#.....##|#.#.##..#.|..#...#..#|##..#.#..#|#......#..|..#...#...|.#.#....##|
#.#.......|........#.|..#.....##|#.....##..|...#.....#|#....##...|..........|.#....#..#|#.......#.|......#...|...#.....#|#..#...#.#|
....#....#|##.......#|#.....#...|.#.....#.#|#..##.#..#|##.#...#..|.#...#.###|#...##.#..|...#..##..|.#.#..#...|........##|#...#..#..|
...#..#...|...#..###.|......#..#|###...#.#.|.......#.#|###.#...##|#...#.....|.#.#....#.|..........|.##..#...#|#.##.#..##|#...##....|
##.#......|..........|.#.#....#.|..#..##.#.|.#....#...|.#...#.###|#..##.....|.#....#..#|#.#...##..|..###....#|#.##......|.....#....|
#...#....#|#.##.#...#|#...#..###|##.....#..|.#..#...#.|.#..#.##.#|##..#...#.|.......#.#|#....#..##|#.##......|..#..#...#|#.###.#...|
......####|#..##.....|..###.##.#|#.#....###|#.###.....|..#..#..#.|...####.#.|......#.#.|..#......#|#.###...##|#.#.....##|##.##.....|
.#.###...#|##.#..#..#|##..#.....|.##..##.##|#......#..|...#.##...|..#.#.####|#####..#..|....#####.|..#..##.#.|...#.##.#.|.##..##..#|
------------------------------------------------------------------------------------------------------------------------------------
.#.###...#|##.#..#..#|##..#.....|.##..##.##|#......#..|...#.##...|..#.#.####|#####..#..|....#####.|..#..##.#.|...#.##.#.|.##..##..#|
#....#...#|#..##.....|...#....##|#.#.......|.#.#......|..##.....#|##...##..#|##.#..#..#|##..#..#.#|#......#..|...#.....#|#.##......|
.##.#.....|.........#|#.........|.......#..|..#.###...|..#....#.#|#.#......#|#...#..#.#|#.#...#..#|#.##....##|#....#....|..#.##....|
...##.###.|.#.#.#....|.#..###...|..#...##..|.......#.#|#.#...#.#.|.#........|..#....###|#..##....#|###......#|#..####.#.|....#....#|
#.##.##..#|#...##...#|#......###|#..####...|....#....#|###....#.#|#....#....|.#..##...#|#.#..#.#..|..#.....##|#..#....##|#.....#.#.|
####.#..##|#.#.#....#|#...#..#..|.#.#.##.##|#...#.#.#.|.##...##.#|#.#.....##|#.....##.#|###.....##|#..#.#..##|#.#....#..|.##.#.....|
#..#.#....|..#.###..#|#..#.###.#|###.#.....|...#..###.|..##...#..|..#...###.|.....##..#|##.##..#..|......#...|.#####.#..|...##....#|
#.......#.|....###.#.|.##....###|#....##.##|#.##....#.|....#..#..|.##...#.##|##...##..#|#..#..#.#.|..##...##.|.#.##.....|...#.....#|
#......#.#|#...#....#|#.##..#...|....#...##|#..#..##.#|#..#....#.|..#....#..|...#..#...|...##....#|#..###..##|#......#..|.#.##..#..|
###...#...|..#.....#.|..#...#.##|##....#.#.|..###.##..|.#...#....|.#....##..|.###..##.#|#.#.#..###|###.######|##.#...##.|..#.###.#.|
------------------------------------------------------------------------------------------------------------------------------------
###...#...|..#.....#.|..#...#.##|##....#.#.|..###.##..|.#...#....|.#....##..|.###..##.#|#.#.#..###|###.######|##.#...##.|..#.###.#.|
..##.#..#.|.#.#..#.#.|..#.......|.#..##...#|#.#......#|#.##...#..|..#.#...##|#.#.#..#.#|#.#...#.#.|..#..#...#|#.....##..|..#....##.|
#....#...#|#...#.....|....#.#.#.|.#..#..#.#|#..#.#...#|##....#...|...##.....|.#.##...#.|....##....|.###..#.#.|...###..#.|.........#|
#.....#..#|#....#...#|#.........|....#..###|#....##.#.|.#..#.....|.#......##|##.#.#....|..#....#..|..#.......|..##.....#|#..##.#..#|
#......#..|........##|#.....#...|.........#|##......#.|.#.#.....#|#.##..###.|.#........|.#...#....|..#.#...#.|.####..#..|...#.#..#.|
##.#...#..|..###....#|#.....#...|.....#...#|#.#..#..##|#.#.......|.....#.###|#.#.#...##|##......##|#..#......|..#.###.#.|..###..###|
#..##.#...|..........|.#........|.........#|#....##..#|##..#.#.#.|.#.......#|#..#..####|##....#..#|##.#..#.##|##.....#..|...#..#...|
#.....#..#|#.........|..........|.#.#.....#|#.......##|#...#.#...|.##....###|#..#..#.##|#...##....|....#.....|.#..#....#|##.#......|
........##|##........|....#...##|#........#|#.#...#...|...#..#.##|#...#.#...|...#.#.##.|.#..##.#.#|#........#|#........#|#.#...#...|
.#..#.#...|.#.######.|..#.##.#.#|#.###....#|#.#.#....#|#...##.###|#...#..#..|.#...#.#..|.#....#.##|###......#|####...##.|.#.###..#.|
